###                 #########
#   ###################     #
# ####                # # # #
# ################### # # # #
#                     # # # #
##################### # # # #
#   ##                # # # #
# # ## ### ############ # # #
# #         #B          # # #
#   ## ################## # #
### ##             ###### # #
### ######### #### ## ### # #
###             ##        # #
###### ######## ########### #
######                      #
A      ######################
