###############################################
#A      #         #     #     #               #
# ##### ##### ### ##### ### ### ##### ##### # #
# #     #   #   #     # #   #     #       # # #
# # ##### # ### ##### # ##### ##### ##### # # #
# #   #   #     #   # #   #   #     #     #   #
# ### ### ##### ### # ##### ### ### ##### #####
#   #   #     #     #     #     #   #         #
### # ##### ########### ####### ##### #########
#   #       #     #   #               #       #
# ##### ##### ### ### ######### ### ##### ### #
#   #     #   #   #   #       #   #     # #   #
### ##### ##### ### ##### ##### ### ##### #####
#     #       #     #   #     #   #   #     # #
##### # ####### ### ##### ##### ##### ##### # #
#     #         #     #   #         #     #   #
# ##### ########### ### ######### ### ##### ###
#   #           #   # #       #   #   #       #
# ### ##### ### ### # ### ### ### ### ### ## ##
#       #     #   #     # #   #     #     #   #
################# ########################## ##
#   #     #   #       #     #         #       #
# ### ### ### ### ##### ### ##### ### ##### ###
#     # #   #   #       #         #   #   #   #
##### ### ### ##### ### ####### ##### ### ### #
#   #   #   #       #   #     #   #         # #
# # ### ### ########### ### ##### # ##### ### #
# #       #             #         #          B#
###############################################
