 # # ###  #B#
 # #   # ## #
   # #   ## #
# ## # # ## #
#    # #    #
### ## ######
A   ##      #
#############